mathdollar = dollar
lcurvyangle = angle.l.curly
ggg = gt.triple
vdash = tack.r
sime = tilde.eq
simeq = tilde.eq
bigcupdot = union.dot.big
Nearrow = arrow.tr.double
Leftrightarrow = arrow.l.r.double
curlywedge = and.curly
interleave = interleave
equiv = equiv
smwhtlozenge = lozenge.stroked.small
intcap = integral.sect
lBrace = brace.l.double
lbrbrak = shell.l
circledparallel = parallel.circle
nvinfty = infinity.bar
hslash = planck.reduce
bigtimes = times.big
Mapsto = arrow.r.double.bar
curvearrowleft = arrow.ccw.half
mupvarsigma = sigma.alt
greater = gt
risingdotseq = eq.dots.up
backprime = prime.rev
perp = perp
gtrsim = gt.tilde
mdlgblksquare = square.filled
tplus = tiny
mupepsilon = epsilon.alt
mdsmblkcircle = circle.filled.tiny
Join = join
mupBeta = Beta
errbarsquare = errorbar.square.stroked
oiint = integral.surf
mupalpha = alpha
mupupsilon = upsilon
infty = oo
Rightarrow = arrow.r.double
ell = ell
leftrightharpoonupup = harpoon.lt.rt
leqq = lt.equiv
gnapprox = gt.napprox
Coloneq = colon.double.eq
equalparallel = parallel.eq
pm = plus.minus
mupmu = mu
mdlgblkdiamond = diamond.filled
BbbA = AA
backdprime = prime.double.rev
boxplus = plus.square
adots = dots.up
geq = gt.eq
Rrightarrow = arrow.r.triple
backtrprime = prime.triple.rev
twoheadmapsfrom = arrow.l.twohead.bar
leftrightarrow = arrow.l.r
minus = minus
origof = original
divideontimes = times.div
varheartsuit = suit.heart.filled
looparrowleft = arrow.l.loop
mupomicron = omicron
subset = subset
varspadesuit = suit.spade.stroked
backsim = tilde.rev
ni = in.rev
bigwedge = and.big
whiteinwhitetriangle = triangle.stroked.nested
boxtimes = times.square
mapsto = mapsto
mathhyphen = hyph
vlongdash = tack.r.long
bigsqcap = inter.sq.big
downharpoonleftbar = harpoon.bl.stop
leftdasharrow = arrow.l.dashed
Exclam = excl.double
bigblacktriangledown = triangle.filled.b
measuredrightangle = angle.right.arc
ddddot = dot.quad
leftrightharpoonsdown = harpoons.lbrb
mathslash = slash
approxident = tilde.triple
ltimes = times.l
bigodot = dot.circle.big
sqsupseteq = supset.eq.sq
ubrbrak = shell.b
Vee = or.double
otimes = times.circle
succ = succ
llblacktriangle = triangle.filled.bl
mdlgwhtcircle = circle.stroked
mupPhi = Phi
emptysetoarrl = nothing.arrow.l
rightdasharrow = arrow.r.dashed
cap = inter
uplus = union.plus
supsetdot = supset.dot
prod = product
sqsubsetneq = subset.sq.neq
Question = quest.double
leftthreearrows = arrows.lll
questeq = eq.quest
mupGamma = Gamma
curlyeqsucc = eq.succ
mdblkdiamond = diamond.filled.medium
BbbR = RR
leftrightarrows = arrows.lr
nni = in.rev.not
vert = bar.v
smblkcircle = bullet
intx = integral.times
lat = lat
longdashv = tack.l.long
mathampersand = amp
approx = approx
div = div
leftarrow = arrow.l
wideangledown = angle.oblique
mathcomma = comma
UUparrow = arrow.t.quad
LLeftarrow = arrow.l.quad
upand = amp.inv
fourvdots = fence.dotted
trianglelefteq = lt.tri.eq
emptysetobar = nothing.bar
mupPsi = Psi
barleftharpoondown = harpoon.lb.stop
uprightcurvearrow = arrow.t.curve
upharpoonleftbar = harpoon.tl.bar
tieinfty = infinity.tie
precnapprox = prec.napprox
late = lat.eq
parallelogramblack = parallelogram.filled
gneq = gt.neq
barleftharpoonup = harpoon.lt.stop
assert = tack.r.short
ogreaterthan = gt.circle
BbbY = YY
eqsim = minus.tilde
dottedcircle = circle.dotted
updownharpoonsleftright = harpoons.tlbr
mupvarrho = rho.alt
leftthreetimes = times.three.l
lrblacktriangle = triangle.filled.br
sphericalangleup = angle.spheric.top
nsim = tilde.not
rceil = ceil.r
whtvertoval = ellipse.stroked.v
mupbeta = beta
dicev = die.five
Re = Re
mupSigma = Sigma
setminus = without
lvzigzag = fence.l
BbbJ = JJ
leftarrowtail = arrow.l.tail
shortdowntack = tack.b.short
varhexagonblack = hexa.filled
simneqq = tilde.nequiv
Rvzigzag = fence.r.double
intlarhk = integral.arrow.hook
updownharpoonrightright = harpoon.tr.br
mupdelta = delta
mdsmwhtcircle = circle.stroked.small
cdot = dot.op
mdsmblksquare = square.filled.small
mupkappa = kappa
upharpoonright = harpoon.tr
rightharpoonup = harpoon.rt
bigstar = star.filled
leftdotarrow = arrow.l.dotted
triangleq = eq.delta
mupEta = Eta
shortuptack = tack.t.short
hrectangleblack = rect.filled.h
errbarblackdiamond = errorbar.diamond.filled
rsolbar = backslash.not
triangletimes = times.triangle
Mapsfrom = arrow.l.double.bar
prime = prime
nexists = exists.not
Swarrow = arrow.bl.double
dashcolon = dash.colon
ointctrclockwise = integral.cont.ccw
npreccurlyeq = prec.curly.eq.not
urblacktriangle = triangle.filled.tr
eqgtr = eq.gt
Subset = subset.double
nsucc = succ.not
mathsemicolon = semi
oplus = xor
BbbM = MM
diamondsuit = suit.diamond.stroked
mathyen = yen
nhpar = parallel.struck
succneq = succ.neq
mupOmega = Omega
mathquestion = quest
rvzigzag = fence.r
dashVdash = tack.l.r
lnapprox = lt.napprox
BbbL = LL
leftrightsquigarrow = arrow.l.r.wave
fullouterjoin = join.l.r
muppi = pi
searrow = arrow.br
nleq = lt.eq.not
bot = tack.t
triangleplus = plus.triangle
Sqcap = inter.sq.double
hourglass = hourglass.stroked
succcurlyeq = succ.curly.eq
nsubseteq = subset.eq.not
biguplus = union.plus.big
lparen = paren.l
flat = flat
mathsterling = pound
downharpoonsleftright = harpoons.blbr
mupgamma = gamma
dualmap = multimap.double
downdownarrows = arrows.bb
Uparrow = arrow.t.double
mupiota = iota
lgwhtsquare = square.stroked.big
BbbW = WW
leftdowncurvedarrow = arrow.l.curve
underparen = paren.b
cdotp = dot.c
cwopencirclearrow = arrow.cw
mupZeta = Zeta
mdblklozenge = lozenge.filled.medium
rangle = angle.r
rightwavearrow = arrow.r.wave
napprox = approx.not
Longrightarrow = arrow.r.double.long
upwhitearrow = arrow.t.stroked
revangle = angle.rev
longmapsfrom = arrow.l.long.bar
varclubsuit = suit.club.stroked
gtreqless = gt.eq.lt
blacktriangleright = triangle.filled.r
Updownarrow = arrow.t.b.double
lessgtr = lt.gt
sqcap = inter.sq
twoheaddownarrow = arrow.b.twohead
xsol = slash.big
Uuparrow = arrow.t.triple
pentagon = penta.stroked
downharpoonleft = harpoon.bl
geqq = gt.equiv
urtriangle = triangle.stroked.tr
eighthnote = note.eighth.alt
BbbF = FF
rangledot = angle.r.dot
BbbV = VV
Lbrbrak = shell.l.double
rightarrowonoplus = plus.circle.arrow
downuparrows = arrows.bt
leftharpoondown = harpoon.lb
vardiamondsuit = suit.diamond.filled
supsetneq = supset.neq
downarrow = arrow.b
errbarcircle = errorbar.circle.stroked
hkswarrow = arrow.bl.hook
leq = lt.eq
cupleftarrow = union.arrow
intbar = integral.dash
mupomega = omega
circledvert = bar.v.circle
mho = Omega.inv
rtimes = times.r
Vvert = bar.v.triple
mdwhtlozenge = lozenge.stroked.medium
blacktriangleleft = triangle.filled.l
barleftarrow = arrow.l.stop
neg = not
succeq = succ.eq
nmid = divides.not
downharpoonright = harpoon.br
leftleftarrows = arrows.ll
ngtrsim = gt.tilde.not
Prec = prec.double
lllnest = lt.triple.nested
boxminus = minus.square
biginterleave = interleave.big
rightrightarrows = arrows.rr
gnsim = gt.ntilde
capdot = inter.dot
wedge = and
rightharpoonupbar = harpoon.rt.stop
Longmapsto = arrow.r.double.long.bar
Cup = union.double
lBrack = bracket.l.double
Dashv = tack.l.double
iinfin = infinity.incomplete
exists = exists
rightarrowtail = arrow.r.tail
rightangle = angle.right
leftwhitearrow = arrow.l.stroked
vrectangleblack = rect.filled.v
veeeq = eq.equi
capwedge = inter.and
eqless = eq.lt
subseteq = subset.eq
downzigzagarrow = arrow.zigzag
smwhtsquare = square.stroked.tiny
similarleftarrow = arrow.l.tilde
smalltriangleright = triangle.stroked.small.r
downarrowbar = arrow.b.stop
leftharpoonsupdown = harpoons.ltlb
rightleftharpoons = harpoons.rtlb
complement = complement
twoheadmapsto = arrow.r.twohead.bar
similarrightarrow = arrow.r.tilde
BbbN = NN
cupdot = union.dot
boxdot = dot.square
mathcolon = colon
lParen = paren.l.double
upharpoonsleftright = harpoons.tltr
awint = integral.ccw
rcurvyangle = angle.r.curly
gtrapprox = gt.approx
preceqq = prec.equiv
propto = prop
gg = gt.double
updownarrows = arrows.tb
equal = eq
nsucccurlyeq = succ.curly.eq.not
bardownharpoonright = harpoon.br.bar
rightleftharpoonsdown = harpoons.rblb
barrightharpoondown = harpoon.rb.bar
lnsim = lt.ntilde
BbbE = EE
lgblksquare = square.filled.big
blacktriangledown = triangle.filled.small.b
equivVert = parallel.equiv
Vert = bar.v.double
Equiv = eq.quad
downharpoonrightbar = harpoon.br.stop
stareq = eq.star
mupXi = Xi
BbbI = II
rightdowncurvedarrow = arrow.r.curve
coloneq = colon.eq
bigcup = union.big
langledot = angle.l.dot
mathoctothorpe = hash
downdasharrow = arrow.b.dashed
looparrowright = arrow.r.loop
ast = convolve
twoheaduparrow = arrow.t.twohead
backcong = tilde.rev.equiv
smallblacktriangleleft = triangle.filled.small.l
Searrow = arrow.br.double
sqsubseteq = subset.eq.sq
ultriangle = triangle.stroked.tl
leftwavearrow = arrow.l.wave
approxeq = approx.eq
leftrightharpoonsup = harpoons.ltrt
BbbS = SS
rBrack = bracket.r.double
rbrace = brace.r
downupharpoonsleftright = harpoons.bltr
threedotcolon = colon.tri.op
varnothing = nothing
lltriangle = triangle.stroked.bl
mathsection = section
mupAlpha = Alpha
circledast = ast.circle
sum = sum
wr = wreath
nlesssim = lt.tilde.not
rAngle = angle.r.double
mdlgblkcircle = circle.filled
ngtrless = gt.lt.not
rightanglesqr = angle.right.sq
intclockwise = integral.cw
Lvzigzag = fence.l.double
eqcolon = eq.colon
mupeta = eta
backslash = backslash
notin = in.not
because = because
nhVvert = interleave.struck
intcup = integral.union
BbbG = GG
tripleplus = plus.triple
precsim = prec.tilde
measuredangle = angle.arc
smblkdiamond = diamond.filled.small
mupxi = xi
mupvarpi = pi.alt
lesseqgtr = lt.eq.gt
overbrace = brace.t
therefore = therefore
mupvartheta = theta.alt
sslash = slash.double
BbbU = UU
mp = minus.plus
hzigzag = dash.wave.double
int = integral
multimap = multimap
caretinsert = caret
succnapprox = succ.napprox
Ddownarrow = arrow.b.triple
sharp = sharp
lgblkcircle = circle.filled.big
lbrack = bracket.l
odot = dot.circle
fallingdotseq = eq.dots.down
twonotes = note.eighth.beamed
mupLambda = Lambda
bigtop = tack.b.big
rightharpoonsupdown = harpoons.rtrb
smalltriangleleft = triangle.stroked.small.l
bigtriangledown = triangle.stroked.b
nrightarrow = arrow.r.not
maltese = maltese
partial = partial
leftrightharpoondownup = harpoon.lb.rt
heartsuit = suit.heart.stroked
longleftsquigarrow = arrow.l.long.squiggly
mapsdown = arrow.b.bar
iiiint = integral.quad
nprec = prec.not
vysmblkcircle = circle.filled.small
mupEpsilon = Epsilon
mupOmicron = Omicron
longleftrightarrow = arrow.l.r.long
downrightcurvedarrow = arrow.b.curve
precneq = prec.neq
mupChi = Chi
diceii = die.two
mupPi = Pi
blkvertoval = ellipse.filled.v
qprime = prime.quad
nsqsupseteq = supset.eq.sq.not
ntrianglerighteq = gt.tri.eq.not
nsupset = supset.not
blackhourglass = hourglass.filled
hookrightarrow = arrow.r.hook
bigtriangleup = triangle.stroked.t
leftouterjoin = join.l
parallelogram = parallelogram.stroked
dottedsquare = square.stroked.dotted
ddagger = dagger.double
nparallel = parallel.not
odiv = div.circle
rightarrowbar = arrow.r.stop
muptau = tau
wedgeq = eq.est
leftrightharpoons = harpoons.ltrb
mapsfrom = arrow.l.bar
Leftarrow = arrow.l.double
quarternote = note.quarter.alt
ncong = tilde.equiv.not
neswarrow = arrow.tr.bl
Vdash = forces
in = in
mupphi = phi.alt
clubsuit = suit.club.filled
smwhtdiamond = diamond.stroked.small
dicei = die.one
succnsim = succ.ntilde
lrtriangle = triangle.stroked.br
rParen = paren.r.double
mapsup = arrow.t.bar
nvDash = tack.r.double.not
rbrbrak = shell.r
geqslant = gt.eq.slant
trianglecdot = triangle.stroked.dot
lbrace = brace.l
sim = tilde.op
Supset = supset.double
BbbX = XX
BbbD = DD
whthorzoval = ellipse.stroked.h
mdwhtdiamond = diamond.stroked.medium
angles = angle.s
mathparagraph = pilcrow
barleftarrowrightarrowbar = arrows.lr.stop
gtrdot = gt.dot
hknwarrow = arrow.tl.hook
mupvarphi = phi
sumint = sum.integral
mdlgwhtlozenge = lozenge.stroked
acwopencirclearrow = arrow.ccw
lgwhtcircle = circle.stroked.big
supseteq = supset.eq
rfloor = floor.r
nwsearrow = arrow.tl.br
curlyeqprec = eq.prec
dotminus = minus.dot
subsetneq = subset.neq
rightanglemdot = angle.right.dot
BbbZ = ZZ
precapprox = prec.approx
Downarrow = arrow.b.double
vee = or
emptysetoarr = nothing.arrow.r
rightharpoondownbar = harpoon.rb.stop
mupvarkappa = kappa.alt
Lleftarrow = arrow.l.triple
errbarblackcircle = errorbar.circle.filled
intBar = integral.dash.double
nearrow = arrow.tr
vartriangleright = gt.tri
rightleftarrows = arrows.rl
rightouterjoin = join.r
forall = forall
nless = lt.not
langle = angle.l
tminus = miny
mupTheta = Theta
mdlgwhtsquare = square.stroked
leftrightharpoondowndown = harpoon.lb.rb
muprho = rho
ddots = dots.down
varhexagon = hexa.stroked
upharpoonrightbar = harpoon.tr.bar
updownharpoonrightleft = harpoon.tr.bl
bigwhitestar = star.stroked
revemptyset = nothing.rev
overparen = paren.t
prec = prec
overbracket = bracket.t
mid = divides
rightdotarrow = arrow.r.dotted
obslash = backslash.circle
gtlpar = angle.spheric.rev
spadesuit = suit.spade.filled
pentagonblack = penta.filled
mdlgwhtdiamond = diamond.stroked
succapprox = succ.approx
dicevi = die.six
vartriangle = triangle.stroked.small.t
angdnr = angle.acute
triangleright = triangle.stroked.r
Doteq = eq.dots
sphericalangle = angle.spheric
ngeq = gt.eq.not
bigvee = or.big
mathplus = plus
updownharpoonleftright = harpoon.tl.br
veedot = or.dot
nlessgtr = lt.gt.not
mupUpsilon = Upsilon
nvdash = tack.r.not
hksearrow = arrow.br.hook
ne = eq.not
bigcap = inter.big
ulblacktriangle = triangle.filled.tl
ll = lt.double
smashtimes = smash
Wedge = and.double
leqslant = lt.eq.slant
lessapprox = lt.approx
leftsquigarrow = arrow.l.squiggly
longrightsquigarrow = arrow.r.long.squiggly
mupMu = Mu
trslash = slash.triple
nwarrow = arrow.tl
doubleplus = plus.double
rightleftharpoonsup = harpoons.rtlt
checkmark = checkmark
bigblacktriangleup = triangle.filled.t
BbbO = OO
downwhitearrow = arrow.b.stroked
mdlgblklozenge = lozenge.filled
uminus = union.minus
hknearrow = arrow.tr.hook
parallel = parallel
subsetdot = subset.dot
triangleminus = minus.triangle
ominus = minus.circle
smblklozenge = lozenge.filled.small
measuredangleleft = angle.arc.rev
smallin = in.small
BbbQ = QQ
mathratio = ratio
dashv = tack.l
lfloor = floor.l
vrectangle = rect.stroked.v
wedgedot = and.dot
barupharpoonright = harpoon.tr.stop
lneqq = lt.nequiv
BbbT = TT
preccurlyeq = prec.curly.eq
hrectangle = rect.stroked.h
nLeftarrow = arrow.l.double.not
mupTau = Tau
increment = laplace
lessdot = lt.dot
nsime = tilde.eq.not
vartriangleleft = lt.tri
barV = tack.b.double
horizbar = bar.h
leftharpoonup = harpoon.lt
Longleftrightarrow = arrow.l.r.double.long
triangledown = triangle.stroked.small.b
circledequal = eq.circle
curlyvee = or.curly
mupKappa = Kappa
barupharpoonleft = harpoon.tl.stop
smeparsl = parallel.slanted.eq.tilde
uparrow = arrow.t
bigsqcup = union.sq.big
cup = union
nsubset = subset.not
blacktriangle = triangle.filled.small.t
underbracket = bracket.b
errbarblacksquare = errorbar.square.filled
BbbH = HH
succsim = succ.tilde
lceil = ceil.l
top = top
updownharpoonleftleft = harpoon.tl.bl
sqsupset = supset.sq
models = models
upharpoonleft = harpoon.tl
muptheta = theta
bigbot = tack.t.big
rightsquigarrow = arrow.r.squiggly
rightarrow = arrow.r
BbbB = BB
Vbar = tack.t.double
oiiint = integral.vol
precneqq = prec.nequiv
curvearrowright = arrow.cw.half
sqsubset = subset.sq
leftrightharpoonupdown = harpoon.lt.rb
rightharpoondown = harpoon.rb
less = lt
eqvparsl = parallel.slanted.equiv
diceiv = die.four
vdots = dots.v
bigotimes = times.circle.big
mathatsign = at
Sqcup = union.sq.double
diameter = diameter
mupnu = nu
dotplus = plus.dot
imageof = image
Cap = inter.double
squoval = square.stroked.rounded
rBrace = brace.r.double
BbbK = KK
sqsupsetneq = supset.sq.neq
mupRho = Rho
nequiv = equiv.not
rightwhitearrow = arrow.r.stroked
swarrow = arrow.bl
nsqsubseteq = subset.eq.sq.not
rparen = paren.r
nRightarrow = arrow.r.double.not
errbardiamond = errorbar.diamond.stroked
succeqq = succ.equiv
Im = Im
leftharpoonupbar = harpoon.lt.bar
supset = supset
nVdash = forces.not
cong = tilde.equiv
bigoplus = xor.big
emptysetocirc = nothing.circle
circleddash = dash.circle
lesssim = lt.tilde
gggnest = gt.triple.nested
times = times
eparsl = parallel.slanted.eq
mupvarepsilon = epsilon
BbbP = PP
baruparrow = arrow.t.stop
longleftarrow = arrow.l.long
dagger = dagger
oint = integral.cont
operp = perp.circle
coprod = product.co
gtrless = gt.lt
barrightharpoonup = harpoon.rt.bar
nabla = nabla
asymp = asymp
ngtr = gt.not
mdsmwhtsquare = square.stroked.small
mathexclam = excl
mupzeta = zeta
vDash = tack.r.double
blkhorzoval = ellipse.filled.h
iint = integral.double
trianglerighteq = gt.tri.eq
muplambda = lambda
updownarrow = arrow.t.b
measeq = eq.m
shortlefttack = tack.l.short
upuparrows = arrows.tt
star = star.op
fint = integral.slash
parsim = parallel.tilde
euro = euro
dddot = dot.triple
diceiii = die.three
smt = smt
smblksquare = square.filled.tiny
mathpercent = percent
twoheadleftarrow = arrow.l.twohead
bardownharpoonleft = harpoon.bl.bar
Succ = succ.double
dotsim = tilde.dot
rightthreetimes = times.three.r
leftharpoondownbar = harpoon.lb.bar
angle = angle
gneqq = gt.nequiv
preceq = prec.eq
mupIota = Iota
nvartriangleleft = lt.tri.not
succneqq = succ.nequiv
mathperiod = dot.basic
updasharrow = arrow.t.dashed
Longleftarrow = arrow.l.double.long
triangleleft = triangle.stroked.l
Colon = colon.double
underbrace = brace.b
threedangle = angle.spatial
diamondcdot = diamond.stroked.dot
unicodeellipsis = dots.h
nvartriangleright = gt.tri.not
obrbrak = shell.t
mupDelta = Delta
nleftrightarrow = arrow.l.r.not
sqint = integral.square
longrightarrow = arrow.r.long
backsimeq = tilde.eq.rev
revnmid = divides.not.rev
nsimeq = tilde.eq.not
rightthreearrows = arrows.rrr
mdwhtsquare = square.stroked.medium
mupsigma = sigma
nsupseteq = supset.eq.not
natural = natural
mupchi = chi
vysmwhtcircle = compose
Longmapsfrom = arrow.l.double.long.bar
varointclockwise = integral.cont.cw
ntrianglelefteq = lt.tri.eq.not
QED = qed
rbrack = bracket.r
nLeftrightarrow = arrow.l.r.double.not
Planckconst = planck
circledcirc = circle.nested
iiint = integral.triple
longmapsto = mapsto.long
unicodecdots = dots.h.c
olessthan = lt.circle
sqcup = union.sq
lAngle = angle.l.double
mupNu = Nu
dprime = prime.double
precnsim = prec.ntilde
cupvee = union.or
twoheadrightarrow = arrow.r.twohead
trprime = prime.triple
hookleftarrow = arrow.l.hook
RRightarrow = arrow.r.quad
boxast = ast.square
DDownarrow = arrow.b.quad
smallni = in.rev.small
mdblksquare = square.filled.medium
nasymp = asymp.not
nleftarrow = arrow.l.not
smallblacktriangleright = triangle.filled.small.r
lneq = lt.neq
Rbrbrak = shell.r.double
smte = smt.eq
lll = lt.triple
muppsi = psi
eqdef = eq.def
BbbC = CC
Nwarrow = arrow.tl.double
